22222222222222222
2...............2
2bcb2.c.c.c.2bcb2
2....b.b.b.b....2
2...b.c.c.c.b...2
2....b.b.b.b....2
2...b.c.c.c.b...2
2....b.b.b.b....2
2...b.c.c.c.b...2
2....b.b.b.b....2
2...b.c.c.c.b...2
2....b.b.b.b....2
2bcb2.c.c.c.2bcb2
2...............2
22222222222222222